11111111111111111111111111111
100011000C0100000000C00001101
10011111000001100011111C00001
11110000000011111101000000011
1P110000000000000100000000E11
10000100100000111111000000001
11111111111111111111111111111