11111111111
1000P0C0001
10000E00001
11111111111