11111111111111111111111111111
100011001C0100000000C00001101
10011111001001100011111C00001
00110000000011111101000010101
1P110000000000000100000001E01
10000100100000111111000000101
11111111111111111111111111111